  111111111111111111111111111111111111111111111111111111111111
  100010000000010010000000000000000000000000000000000000000001
11100010000000010000000000000000000000000000000000000000000001
10000010000000010010000000000000000000000000000000000000000001
10000010011110000010000000000000000000000000000000000000000001
10000010000000010010000000000000000000000000000000000000000001
10010000100010000010000000000000000000000000000000000000000001
10000000000001010010000000000000000000000000000000000000000001
10000000111000010010000000000000000000000000000000000000000001
100000101 1000000010000000000000000000000000000000000000000001
10000010111000010010000000000000000000000000000000000000000001
10010010000000000000000000000000000000000000000000000000000001
10000010000000000000000000000000000000000000000000000000000001
11111111100000000000000000000000000000000000000000000000000001
10000000100000000000000000000000000000000000000000000000000001
        100000000000000000000000000000000000000000000000000001
        100000000000000000000000000000000000000000000000000001
        100000000000000000000000000000000000000000000000000001
        100000000000000000000000000000000000000000000000000001
11111111100000000000000000000000000000000000000000000000000001
10000000000000000000000000000000000000000000000000000000000001
11110111100000000000000000000000000000000000000000000000000001
11110111100000000000000000000000000000000000000000000000000001
11000000100000000000000000000000000000000000000000000000000001
10000000000000000000000000000000000000000000000000000000000001
100000000000000N0000000000000000000000000000000000000000000001
11000001100000000000000000000000000000000000000000000000000001
11110111011101010101111111111111111111111111111111111111111111
11111111111111111111111111111111111111111111111111111111111111