  1111111111111111111111
  1000100000000100100001
111000100000000100000001
100000100000000100100001
100000100111100000100001
100000100000000100100001
100100001000100000100001
100000000000010100100001
100000001110000100100001
100000101 10000000100001
100000101110000100100001
100100100000000000000001
100000100000000000000001
111111111000000000000001
100000001000000000000001
        1000000000000001
        1000000000000001
        1000000000000001
        1000000000000001
111111111000000000000001
100000000000000000000001
111101111000000000000001
111101111000000000000001
110000001000000000000001
100000000000000000000001
100000000000000N00000001
110000011000000000000001
111101110111010101011111
111111111111111111111111