  1111111111111111111111
  1000100000000100100001
111000100000000100000001
100000100000000100100001
100000100111100000100001
100000100000000100100001
100100001000100000100001
100000000000010100100001
100000001110000100100001
100000101 10000000100001
100000101110000100100001
100100100000010000100001
1000001000S0000100100001
111111111111111111111111
