111111111111111111111111
100000100000000100100001
100000100000000100000001
100000100000000100100001
100000100111100100100001
100000100000000100100001
100000000000000100100001
100000000000000100100001
1000000000S0000100100001
100000100000000100100001
100000100000000100100001
100000100000000000100001
100000100000000100100001
111111111111111111111111
