1111111111111111111111111111111111111
1000000000000100000000000000100100001
1000000000000100000000000000100000001
1000000000000100000000000000100100001
1000000000000100111111110000100100001
1000000000000100000000000000100100001
1000000000000000000000000000100100001
1000000000000000000000000000100100001
1000000000000000000000000000100100001
1000000000000100000000000000100100001
1000000000000100000000000000100100001
10000000000001000000000000000W0100001
1000000000000100000000000000100100001
1111111111111111111111111111111111111
