11111111111111111111111111111
10000000001100000000000010001
10110000011100000000000010001
10010000000000000000000010001
11111011000001110000000000001
10000000001100000111011111111
11110111111111011100000010001
11110111111111011101010000001
11000000110101011100000010001
10000000000000001100000010001
100000000E0000001101010010001
11000001110101011101011110001
11110111 1110101 101111000001
11111111 1111111 111111111111
