1111111111111111
           1111110000000000000011111
         11000000000000000000111000000111
       1111100000000000001110000000000001110011
     11101111000000000111000000000000000001110000011
   1110000011000011100110000000000000000000011100000001
  11100000000001110000001100000000000000000011100000000001
 11100000000001111111000000000011110000000011110000000001001
11100011100000110000000000000010001100000011110000000011100001
1100101110100011000001100000000000001000000110000000111100000001
11011100111000011011100000000000000001000000000000000000000000001
110000000000000011000000000000000000010001110000000000000000000001
1100000000000000011000111000000000000000111000000001111000000000001
110000000010101001101111000000000000000111100000011111110000000000001
11000000000101110101100000000011000000001111000000000000000000000000001
 110000000001111110011000000001111000000001110000000000000000000000000001
 11100000000010111100011000000001111000000001100000010000000000000000000111
  11100000000001111000001110000000011000000111110000011000000000000000110011
   111000000000011 000000001110000111000001111111111000110     1110000001100
   111000000000011 000000000111111111111111111111001  1001          11000001
    11000000000111 000000001111111111    1111111000                   110000
    11100000001111 00000000011111        1111110001                    11000
     110000001111110000000000111        1111110000                    110001
     11100000111 11100000000001111      1111100001                   110001
      1110000111 111110000000000111     111100000                   11001
       1110000111 111111000000000011   1111000001                   1101
        1110000111 1111111000000000111 111000000                    1101
         1110000111 111111111110000111 111000001                     1101
          1110000111111111111111111111 11100000                       1001
            110000111111100111111111   11000001                        100
             110000111100000111111     110000001
             11000011 11110000001     10000000001
             11111011    101111       11111011111