1111111111111111111111111111111111111
1E11111111111111111111111000111111111
1000111111111111111111100010111111111
1110111111111111111111101110001111111
1110001111111111111110001111101111111
1111101111111111111110111111100011111
1111100011111111111000111111111000111
1111111011111111111011111111111110111
1111111000111111100011111111111110001
1111111110111111101111111111111111101
1111111110001110001111111111111111101
1111111111100010111111111111111111101
1111111111111000111111111111111111101
1111111111111111111111111111111111111
