11111111111111111111111111111
100000000011000000000000100C1
10110000011100000000000010001
10010000000000000000000010001
11111011000001110000000000001
10000000001100000111011111111
11110111111111011100000010001
11110111111111011101010000001
11000000110101011100000010001
10000000000000001100000010001
10000000000000001101010010001
11000001110101011101011110N01
11110111111101011101111000001
11111111111111111111111111111
