1111111111111111111111111111111111111
1E00000000000100000000000000100100001
1000000000000100000000000000100000001
1000000000000100000000000000100100001
1000000000000100000000000000100100001
1000000000000100000000000000100100001
1000000000000000000000000000100100001
1000000000000000000000000000100100001
1000000000000000000000000000100100001
1000000000000100000000000000100100001
1000000000000100000000000000100100001
1000000000000100000000000000000100001
1000000000000100000000000000100100001
1111111111111111111111111111111111111
